NO ./path_to_the_north_texture
SO ./path_to_the_south_texture
WE ./path_to_the_west_texture
EA ./path_to_the_east_texture
F 220,100,0
C 225,30,0

               1111     1111
         111111101111111111111111
         1000000000110000000000001           111
         1011000111110000000000001           1N1
         10010001 	1000000000000001         111
111111111011000011110000000000001
100000000011000001110111111111111
11110111111111011100000010001
11110111111111011101010010001						000
1100000011010101110000001000D1						000
10000000000000001100000010001						000
10000000000000001101010010001
11000001110101011111011110N011 111  1111
11110111 1110101 101111010001
11111111 1111111 111111111111

 0
1D1
 0

 1
0D0
 1