NO ./path_to_the_north_texture
SO ./path_to_the_south_texture
WE ./path_to_the_west_texture
EA ./path_to_the_east_texture
F 220,100,0
C 250,30,0

11111  111111                  1
10001  100001                 1S1
10001  110001 1 1 1            1
10001   10001    1  111
11111   11111111101 101  11111111111111111111111
1111111111111111111 111



111111111111111111111111111111111111111111

    11111111111
1111 1 1 101 1
    11111111111

 1
1011
1011  11111
1011  10001
1011  10101
 1    10001
      11111





