NO ./path_to_the_north_texture
SO ./path_to_the_south_texture
WE ./path_to_the_west_texture
EA ./path_to_the_east_texture
F 194,178,128
C 135,206,235

111111111111111
1000000000000001
1010001000001111
1000000001001
100N111111111
10001
11111
