NO ./textures/Sunflowers.png
SO ./textures/Wheat_field.png
WE ./textures/the_starry_night.png
EA ./textures/Impression_Sunrise.png
F 194,178,128
C 135,206,235

111111111111111
1000000000000001
10100N1000001111
1000000001001
1000111111111
10001
11111
