NO ./textures/Sunflowers.png
SO ./textures/Wheat_Field.png
WE ./textures/the_starry_night.png
EA ./textures/Impression_Sunrise.png
F 194,178,128
C 135,206,235

111111111111111
1000000000000001
1000011100001111
100001 100001
1000011100001
1000000000001
10N0111111111
10001
11111
