NO ./textures/Sunflowers.png
SO ./textures/Wheat_Field.png
WE ./textures/the_starry_night.png
EA ./textures/Impression_Sunrise.png
F 194,178,128
C 135,206,235

11111111111111111111111111111111
1N000000000000000000000000000001
11111111111111111111111111111111
1
1
1
1
1
1
1
1
1
1
1
1
1
1
