11111111111111111111
10000000000000000001
10000000001111111101
10000000001      101
10000100001      101
10000000001      101
10000N00001      101
10000000001111111101
10000000000000000001
11111111111111111111
