NO ./textures/Brick_Wall_Brown.png
SO ./textures/Brick_Wall_Grey.png
WE ./textures/Brick_Wall_Red.png
EA ./textures/Old_Brick_Wall.png
F 194,178,128
C 135,206,235

11111111111111111111
10000000000000000001
10N00100001111111101
10000100001      101
10000100001      101
10000000001      101
10000000001      101
10000000001111111101
10000000000000000001
11111111111111111111