NO ./textures/Sunflowers.png
SO ./textures/Wheat_Field.png
WE ./textures/the_starry_night.png
################
EA ./textures/Impression_Sunrise.png
F 194,178,128
C 135,206,235

1111111111111111
1000000000000001
1010S01000001111
1000000001001
1000111111111
10001
11111
