NO ./textures/Old_Brick_Wall.png
SO ./textures/Stucco_Wall_White.png
WE ./textures/Decorative_Brick_Sandstone.png
EA ./textures/Decorative_Brick_Tan.png
F 194,178,128
C 135,206,235

111111111
100000001
1D1D1D0D1
100N00001
111111111